**********
*    *   *
* ** * **
* *     *
* ******* 
*        *
**********
